%%%%%%%%%%
%.      .%
%  P     %
%        %
%        %
%        %
%        %
%        %
%        %
%        %
%        %
%        %
%        %
%        %
%        %
%.      .%
%%%%%%%%%%
